WWWWWWWWWWWWWWWWWWWWWWWWWWWW
WEEEEEEEEEEEEWWEEEEEEEEEEEEW
WEWWWWEWWWWWEWWEWWWWWEWWWWEW
WEWWWWEWWWWWEWWEWWWWWEWWWWEW
WEWWWWEWWWWWEWWEWWWWWEWWWWEW
WEEEEEEEEEEEEEEEEEEEEEEEEEEW
WEWWWWEWWEWWWWWWWWEWWEWWWWEW
WEWWWWEWWEWWWWWWWWEWWEWWWWEW
WEEEEEEWWEEEEWWEEEEWWEEEEEEW
WWWWWWEWWWWWEWWEWWWWWEWWWWWW
WWWWWWEWWWWWEWWEWWWWWEWWWWWW
WWWWWWEWWEEEPICEEEEWWEWWWWWW
WWWWWWEWWEWWWWWWWWEWWEWWWWWW
WWWWWWEWWEWWWWWWWWEWWEWWWWWW
WWWWWWEEEEWWWWWWWWEEEBWWWWWW
WWWWWWEWWEWWWWWWWWEWWEWWWWWW
WWWWWWEWWEWWWWWWWWEWWEWWWWWW
WWWWWWEWWEEEEEEEEEEWWEWWWWWW
WWWWWWEWWEWWWWWWWWEWWEWWWWWW
WWWWWWEWWEWWWWWWWWEWWEWWWWWW
WEEEEEEEEMEEEWWEEEEEEEEEEEEW
WEWWWWEWWWWWEWWEWWWWWEWWWWEW
WEWWWWEWWWWWEWWEWWWWWEWWWWEW
WEEEWWEEEEEEEEEEEEEEEEWWEEEW
WWWEWWEWWEWWWWWWWWEWWEWWEWWW
WWWEWWEWWEWWWWWWWWEWWEWWEWWW
WEEEEEEWWEEEEWWEEEEWWEEEEEEW
WEWWWWWWWWWWEWWEWWWWWWWWWWEW
WEWWWWWWWWWWEWWEWWWWWWWWWWEW
WEEEEEEEEEEEEEEEEEEEEEEEEEEW
WWWWWWWWWWWWWWWWWWWWWWWWWWWW