WWWWWWWWWWWWWWWWWWWW
WWEEEEEEEEWEEEEEEEEWW
WWEWWEWWWEWEWWWEWWEWW
WWEWWEWWWEWEWWWEWWEWW
WWEEEEEEEEEEEEEEEEEWW
WWEWWEWEWWWWWEWEWWEWW
WWEEEEWEEEWEEEWEEEEWW
WWWWWEWWWEWEWWWEWWWWW
WWWWWEWEEECEEEWEWWWWW
WWWWWEWEWWEWWEWEWWWWW
WWEEEEEEWBIPWEEEEEEWW
WWWWWEWEWWWWWEWEWWWWW
WWWWWEWEEEEEEEWEWWWWW
WWWWWEWEWWWWWEWEWWWWW
WWEEEEEEEEWEEEEEEEEWW
WWEWWEWWWEWEWWWEWWEWW
WWEEWEEEEEMEEEEEWEEWW
WWWEWEWEWWWWWEWEWEWWW
WWEEEEWEEEWEEEWEEEEWW
WWEWWWWWWEWEWWWWWWEWW
WWEEEEEEEEEEEEEEEEEWW
WWWWWWWWWWWWWWWWWWWWW
WWWWWWWWWWWWWWWWWWWW
WWWWWWWWWWWWWWWWWWWW