WWWWWWWWWWWWWWWWWWWWWWWWWWWW
WDDDDDDDDDDDDWWDDDDDDDDDDDDW
WDWWWWDWWWWWDWWDWWWWWDWWWWDW
WDWWWWDWWWWWDWWDWWWWWDWWWWDW
WDWWWWDWWWWWDWWDWWWWWDWWWWDW
WDDDDDDDDDDDDDDDDDDDDDDDDDDW
WDWWWWDWWDWWWWWWWWDWWDWWWWDW
WDWWWWDWWDWWWWWWWWDWWDWWWWDW
WDDDDDDWWDDDDWWDDDDWWDDDDDDW
WWWWWWDWWWWWDWWDWWWWWDWWWWWW
WWWWWWDWWWWWDWWDWWWWWDWWWWWW
WWWWWWDWWDDDDDDDDDDWWDWWWWWW
WWWWWWDWWDWWHHHHWWDWWDWWWWWW
WWWWWWDWWDWWWWWWWWDWWDWWWWWW
WWWWWWDDDDWWPICBWWDDDDWWWWWW
WWWWWWDWWDWWWWWWWWDWWDWWWWWW
WWWWWWDWWDWWWWWWWWDWWDWWWWWW
WWWWWWDWWDDDDDDDDDDWWDWWWWWW
WWWWWWDWWDWWWWWWWWDWWDWWWWWW
WWWWWWDWWDWWWWWWWWDWWDWWWWWW
WDDDDDDDDMDDDWWDDDDDDDDDDDDW
WDWWWWDWWWWWDWWDWWWWWDWWWWDW
WDWWWWDWWWWWDWWDWWWWWDWWWWDW
WDDDWWDDDDDDDDDDDDDDDDWWDDDW
WWWDWWDWWDWWWWWWWWDWWDWWDWWW
WWWDWWDWWDWWWWWWWWDWWDWWDWWW
WDDDDDDWWDDDDWWDDDDWWDDDDDDW
WDWWWWWWWWWWDWWDWWWWWWWWWWDW
WDWWWWWWWWWWDWWDWWWWWWWWWWDW
WDDDDDDDDDDDDDDDDDDDDDDDDDDW
WWWWWWWWWWWWWWWWWWWWWWWWWWWW